107
8
22	4	0	0	0	0	0	0	0	0	0	0	0	0	0	0	0	0	0	0	0	0	0	0	0	0	0	0	0	0	0	0	0	0	0	0	0	0	0	0	0	0	0	0	0	0	0	0	0	0	0	0	0	0	0	0	0	0	0	0	0	0	0	0	0	0	0	0	0	0	0	0	0	0	0	0	0	0	0	0	0	0	0	0	0	0	0	0	0	0	0	0	0	0	0	0	0	0	0	0	0	0	0	0	0	0	22
22	4	0	0	0	0	0	0	0	0	0	0	0	0	0	0	0	0	0	0	0	0	0	0	0	0	0	0	0	0	0	0	0	0	0	0	0	0	0	0	0	0	0	0	0	0	0	0	0	0	0	0	0	0	0	0	0	0	0	0	0	0	0	0	0	0	0	0	0	0	0	0	0	0	0	0	0	0	0	0	0	0	0	0	0	0	0	0	0	0	0	0	0	0	0	0	0	0	0	0	0	0	0	0	0	0	22
22	4	0	0	0	0	0	0	0	0	0	0	13	0	0	0	0	0	14	0	0	0	0	0	0	0	0	0	0	0	0	0	0	0	0	0	0	0	0	0	10	0	0	0	0	0	0	0	0	0	0	0	0	0	0	0	0	0	0	0	0	0	0	0	0	0	0	0	14	0	0	0	0	0	0	0	0	0	0	0	0	0	0	0	0	0	0	0	0	0	0	0	0	0	0	0	0	0	0	0	0	0	0	0	0	0	22
22	4	0	0	0	0	0	0	0	0	0	0	0	0	0	11	0	0	0	0	0	0	0	0	0	0	0	0	0	0	0	0	0	0	11	0	0	0	0	23	24	25	0	0	0	0	0	0	0	0	0	0	0	0	0	0	0	0	0	0	0	0	0	0	0	10	0	0	0	0	0	0	0	0	0	0	0	0	0	0	0	0	9	0	0	0	0	0	0	0	0	0	0	0	0	0	0	0	0	0	0	0	0	0	0	0	22
22	4	0	0	0	12	0	0	0	0	0	0	11	3	21	21	2	0	0	0	0	0	0	0	0	0	0	0	0	0	0	0	0	23	25	0	0	0	0	0	0	0	0	0	0	9	11	0	0	0	0	0	0	0	0	0	0	0	0	0	0	0	0	0	3	22	4	0	0	0	0	0	0	0	0	0	0	0	0	0	23	24	25	0	0	3	21	2	0	0	0	0	0	0	0	0	0	0	0	0	0	0	0	0	0	0	22
22	4	0	0	0	0	0	0	0	0	3	22	22	22	21	21	2	0	0	0	0	0	10	9	0	0	0	0	0	0	10	0	0	0	0	0	0	11	0	0	0	0	0	3	22	22	22	22	2	0	0	0	9	0	0	0	0	9	0	0	0	3	22	22	3	22	4	0	0	0	0	0	0	0	0	0	0	0	0	0	0	0	0	0	0	3	21	2	0	0	0	0	0	0	0	0	0	0	0	0	0	0	0	0	0	0	22
22	4	9	0	10	0	0	0	0	11	3	22	22	22	21	21	2	0	0	0	3	22	22	22	22	4	0	0	9	3	22	22	2	0	9	3	21	21	4	0	0	0	0	3	22	22	22	22	2	10	0	3	22	2	0	0	3	22	2	11	3	22	22	22	3	22	4	0	0	0	0	0	0	9	0	0	10	9	0	0	11	0	0	3	22	3	21	2	0	0	0	0	0	0	0	0	0	0	0	10	11	0	0	9	0	0	22
22	21	21	21	21	21	21	21	21	21	21	22	22	22	21	21	2	0	0	0	3	22	22	22	22	21	21	21	21	21	22	22	21	21	21	21	21	21	4	0	0	0	0	3	22	22	22	22	21	21	21	21	22	21	21	21	21	22	21	21	21	22	22	22	3	22	4	0	0	0	0	1	21	21	21	21	21	21	21	21	21	21	21	21	22	3	21	21	21	21	21	21	21	21	21	21	21	21	21	21	21	21	21	21	21	21	22